1111111111111
1CCCCCPCCCCC1
11CCCCCCCCC11
1C1CCCCCCCCC1
1CC1C010C1CC1
1CCCCCEC1CCC1
1111111111111