1111111111
11P0000001
1C1000001
1000000001
1E00000001
1111111111