1111111111
1000P001C1
10E1100111
10000000C1
1111111111