111111111
1000PCC01
111000001
1E0001111
111111111