1111111111111111111111111111111111111111111
1111101CCCCCCCCCCCCCCCCC10000C0000000000001
1E00000100000010000010000000001100000100001
1010010010000010000100001000000110000101001
1000101010000010001000000000000011000001001
1010010001000010010000101000000001100000011
1011010001000100000000100000100000110000001
101001000001001000000100000010000001100C001
101001C000001010000001001000100010001100001
101001000000001000001000C0P0100000000000001
1010000000001010000010001000100010000011001
1010010000010010000100000000100000000001101
1000010000100000000100000001100001000100111
101001000100001CCCCCCCCCCC11000010000100001
1111111111111111111111111111111111111111111
